64
G...............................................................
.................#..#.........................................#.
..........#.#..#..........#.#.................................#.
.......#......................#...............................#.
....##.........................#..............................#.
.....##.......................................................#.
......##.......................#..............................#.
.......##.................................................#####.
........##...................#.................#.#.#.#..###...#.
.........##...........................#...#..#................#.
..........#......................#.#..........................#.
..........##.##.#..#...#..#.#..#..............................#.
..........###......................##.........................#.
...........##.............##....##............................#.
.....................#........#...............................#.
...........#.#...........#....................................#.
.............##...............................................#.
................#..#.....#....................................#.
..............#.........#.....................................#.
.................#............................................#.
..........#......#......#.....................................#.
.................#.......#....................................#.
.....#..........#..........#...#..............................#.
..#................................#..............##..........#.
...............#......................#.......#..#............#.
.............#........................#.........#.............#.
.....................................#.....#..................#.
...........#............................#....#................#.
..............................................................#.
.........#.......................#............................#.
...................................#.......#..................#.
............................#.................................#.
.......#..................................#...................#.
.....#...........................#............................#.
......................#.......................................#.
.....#..........................#........#....................#.
......#.......................................................#.
...............#.........................#....................#.
........#.....................................................#.
#................................#........#...................#.
...#.....#.#..................................................#.
......#.#.....................................................#.
.......##.#.###.............................#.................#.
.........#.#...#..#.#.............#...........................#.
.......................##....................#................#.
...........................#.................#................#.
.............................#................................#.
............................#....#..........##................#.
.....................................#..#.##..................#.
............................#.................................#.
..............................................................#.
..........................#...................................#.
..............................................................#.
.........................#.............#......................#.
..............................................................#.
..............................................................#.
........................#.....................................#.
........................................#.....................#.
..............................................................#.
........................#.....................................#.
..........................#...................................#.
........................................#.....................#.
............................#.................................#.
..............................................................#S
