20
...##.#.#.#.#.......
.#.##.#.#.#.#.######
##.##.#.#.#.#.......
.#.##.#.#.#.#.######
.#...#.#.#.#.......#
.##.#########.######
....................
.##.#########.#####.
.##.#.........#.....
.##.###########.####
.##.###.G#S......###
.##...#.####.#.#....
.####.#..#.#.#.#.###
.####.##.#...#.#....
.##....#.#####.#.###
....##.#.#.....#....
.####..#.#.#####.###
....#.##.#.........#
..#.#.#..#######.#.#
.##.#...#........#..
